//MAP CONVERTED BY dmm2tgm.py THIS HEADER COMMENT PREVENTS RECONVERSION, DO NOT REMOVE
"bs" = (
/obj/structure/jungle/vines/heavy,
/turf/open/floor/plating/ground/dirtgrassborder/corner{
	dir = 4
	},
/area/lv624/ground/jungle8)
"cm" = (
/obj/structure/sign/securearea,
/turf/open/floor/plating/ground/dirt,
/area/lv624/ground/sand9)
"dc" = (
/turf/open/ground/coast{
	dir = 6
	},
/area/lv624/ground/river3)
"dv" = (
/obj/effect/ai_node,
/turf/open/floor/plating/ground/dirt,
/area/lv624/lazarus/sandtemple)
"eq" = (
/turf/open/ground/coast/corner2{
	dir = 1
	},
/area/lv624/ground/river3)
"er" = (
/obj/structure/stairs/seamless{
	dir = 4;
	color = "#ffc9b3";
	resistance_flags = 1
	},
/turf/open/floor/plating/ground/dirt,
/area/lv624/lazarus/sandtemple)
"eP" = (
/obj/structure/flora/grass/brown,
/turf/open/ground/river,
/area/lv624/ground/river3)
"fB" = (
/obj/structure/fence,
/obj/structure/sign/securearea,
/turf/open/floor/plating/ground/dirt,
/area/lv624/ground/sand9)
"fY" = (
/turf/open/ground/coast/corner{
	dir = 8
	},
/area/lv624/ground/river3)
"gh" = (
/turf/open/ground/coast/corner{
	dir = 1
	},
/area/lv624/ground/river3)
"gq" = (
/turf/open/ground/coast/corner2{
	dir = 8
	},
/area/lv624/ground/sand6)
"gQ" = (
/obj/structure/fence,
/turf/open/floor/plating/ground/dirt,
/area/lv624/ground/sand9)
"gX" = (
/turf/open/ground/coast/corner{
	dir = 4
	},
/area/lv624/ground/river3)
"hB" = (
/obj/structure/prop/brazier/torch/frame,
/turf/closed/wall/mineral/sandstone/runed,
/area/lv624/lazarus/sandtemple)
"hE" = (
/obj/effect/turf_decal/warning_stripes/thin{
	dir = 1
	},
/obj/effect/ai_node,
/turf/open/floor,
/area/lv624/ground/sand9)
"hG" = (
/obj/structure/stairs/seamless{
	dir = 8;
	color = "#ffc9b3";
	resistance_flags = 1
	},
/turf/open/floor/plating/ground/dirt,
/area/lv624/lazarus/sandtemple)
"iX" = (
/obj/effect/turf_decal/sandytile,
/obj/effect/turf_decal/sandytile,
/turf/open/floor/sandstone/runed,
/area/lv624/lazarus/sandtemple)
"jh" = (
/obj/structure/jungle/vines/heavy,
/turf/open/ground/grass,
/area/lv624/ground/jungle8)
"jq" = (
/turf/closed/wall/mineral/sandstone/runed,
/area/lv624/ground/sand3)
"km" = (
/turf/open/floor/plating/ground/dirtgrassborder/corner{
	dir = 4
	},
/area/lv624/ground/jungle8)
"kp" = (
/obj/structure/flora/ausbushes/reedbush,
/turf/open/floor/plating/ground/dirt,
/area/lv624/ground/river3)
"kv" = (
/obj/structure/platform_decoration{
	icon_state = "stone_deco";
	color = "#b29082";
	resistance_flags = 1;
	name = "sandstone platform";
	dir = 4
	},
/turf/open/floor/plating/ground/dirt/dug,
/area/lv624/lazarus/sandtemple)
"lb" = (
/turf/open/ground/grass/grass2,
/area/lv624/ground/jungle8)
"lg" = (
/obj/structure/platform{
	dir = 1;
	icon_state = "stone";
	resistance_flags = 1;
	name = "sandstone platform";
	color = "#b29082"
	},
/turf/open/floor/plating/ground/dirt,
/area/lv624/ground/sand6)
"lu" = (
/turf/open/ground/coast{
	dir = 1
	},
/area/lv624/ground/river3)
"lP" = (
/obj/structure/flora/ausbushes/reedbush,
/turf/open/ground/river,
/area/lv624/ground/river3)
"mj" = (
/obj/structure/jungle/vines,
/obj/structure/prop/brazier/torch/frame,
/turf/closed/wall/mineral/sandstone/runed,
/area/lv624/lazarus/sandtemple)
"mm" = (
/obj/structure/jungle/vines,
/turf/open/floor/plating/ground/dirtgrassborder/corner2{
	dir = 1
	},
/area/lv624/ground/jungle8)
"mq" = (
/turf/open/ground/coast,
/area/lv624/ground/river3)
"mz" = (
/obj/effect/turf_decal/sandytile,
/turf/open/floor/tile/whiteyellow/full,
/area/lv624/lazarus/sandtemple)
"mL" = (
/turf/closed/gm/dense,
/area/lv624/ground/caves/rock)
"mT" = (
/obj/effect/turf_decal/warning_stripes/thin{
	dir = 8
	},
/turf/open/floor/plating/ground/dirt,
/area/lv624/ground/sand9)
"nh" = (
/obj/structure/platform{
	dir = 1;
	icon_state = "stone";
	resistance_flags = 1;
	name = "sandstone platform";
	color = "#b29082"
	},
/turf/open/floor/plating/ground/dirt,
/area/lv624/lazarus/sandtemple)
"og" = (
/obj/structure/jungle/plantbot1/alien,
/turf/open/floor/plating/ground/dirt,
/area/lv624/ground/sand9)
"om" = (
/turf/open/floor/sandstone/runed,
/area/lv624/lazarus/sandtemple)
"oG" = (
/obj/structure/platform{
	dir = 1;
	icon_state = "stone";
	resistance_flags = 1;
	name = "sandstone platform";
	color = "#b29082"
	},
/obj/structure/stairs/seamless{
	dir = 4;
	color = "#ffc9b3";
	resistance_flags = 1
	},
/turf/open/floor/sandstone/runed,
/area/lv624/lazarus/sandtemple)
"oJ" = (
/turf/closed/wall/mineral/sandstone/runed,
/area/lv624/lazarus/sandtemple)
"oY" = (
/obj/effect/landmark/weed_node,
/turf/open/floor/plating/ground/dirt,
/area/lv624/ground/sand3)
"pO" = (
/turf/open/ground/river,
/area/lv624/ground/sand6)
"qF" = (
/obj/effect/landmark/weed_node,
/turf/open/ground/river,
/area/lv624/ground/river3)
"qK" = (
/obj/effect/turf_decal/warning_stripes/thin{
	dir = 2
	},
/obj/effect/landmark/weed_node,
/obj/effect/turf_decal/warning_stripes/thin{
	dir = 6
	},
/turf/open/floor,
/area/lv624/ground/sand9)
"qS" = (
/turf/open/floor/plating/ground/dirt,
/area/lv624/ground/river3)
"rc" = (
/obj/effect/ai_node,
/turf/open/ground/coast/corner{
	dir = 4
	},
/area/lv624/ground/sand6)
"rh" = (
/obj/effect/ai_node,
/turf/open/ground/coast/corner,
/area/lv624/ground/river3)
"sy" = (
/obj/structure/girder,
/turf/open/floor/plating/ground/dirt,
/area/lv624/lazarus/sandtemple)
"sC" = (
/obj/effect/ai_node,
/turf/open/floor/sandstone/runed,
/area/lv624/lazarus/sandtemple)
"tf" = (
/obj/structure/platform{
	dir = 1;
	icon_state = "stone";
	resistance_flags = 1;
	name = "sandstone platform";
	color = "#b29082"
	},
/obj/structure/stairs/seamless{
	dir = 8;
	color = "#ffc9b3";
	resistance_flags = 1
	},
/turf/open/floor/sandstone/runed,
/area/lv624/lazarus/sandtemple)
"tl" = (
/obj/effect/decal/cleanable/blood/splatter/animated,
/obj/effect/landmark/weed_node,
/turf/open/floor/plating/ground/dirt,
/area/lv624/lazarus/sandtemple)
"tA" = (
/obj/item/weapon/claymore/mercsword/machete,
/turf/open/floor/plating/ground/dirt,
/area/lv624/lazarus/sandtemple)
"tP" = (
/obj/structure/showcase/six{
	icon_state = "statue";
	color = "#95948B";
	name = "Eternal guardian";
	desc = "A grey statue dawned in ancient armor, it stares into your soul.";
	resistance_flags = 1
	},
/obj/item/clothing/mask/yautja_flavor{
	anchored = 1
	},
/obj/item/clothing/shoes/yautja_flavor{
	anchored = 1
	},
/obj/item/weapon/harpoon/yautja{
	pixel_x = 6;
	anchored = 1;
	name = "alien harpoon"
	},
/obj/structure/jungle/vines,
/turf/open/floor/sandstone/runed,
/area/lv624/lazarus/sandtemple)
"vt" = (
/obj/structure/jungle/plantbot1/alien,
/turf/open/floor/plating/ground/dirt,
/area/lv624/ground/river3)
"vZ" = (
/obj/machinery/floodlight/colony,
/turf/open/floor/plating/ground/dirt,
/area/lv624/ground/sand9)
"wT" = (
/obj/structure/platform{
	dir = 1;
	icon_state = "stone";
	resistance_flags = 1;
	name = "sandstone platform";
	color = "#b29082"
	},
/obj/structure/jungle/vines,
/turf/open/ground/coast/corner{
	dir = 1
	},
/area/lv624/ground/sand6)
"yc" = (
/turf/open/floor/plating/ground/dirt,
/area/lv624/ground/sand6)
"yr" = (
/turf/open/ground/coast,
/area/lv624/ground/sand6)
"yt" = (
/turf/open/floor/plating/ground/dirt,
/area/lv624/lazarus/sandtemple)
"yL" = (
/obj/structure/jungle/vines,
/turf/open/floor/plating/ground/dirt,
/area/lv624/lazarus/sandtemple)
"zi" = (
/obj/structure/showcase/six{
	icon_state = "statue";
	color = "#95948B";
	name = "Eternal guardian";
	desc = "A grey statue dawned in ancient armor, it stares into your soul.";
	resistance_flags = 1
	},
/obj/item/clothing/shoes/yautja_flavor{
	anchored = 1
	},
/obj/item/clothing/suit/armor/yautja_flavor{
	soft_armor = list("melee"=20,"bullet"=30,"laser"=25,"energy"=10,"bomb"=15,"bio"=0,"fire"=10,"acid"=10);
	anchored = 1
	},
/obj/item/weapon/harpoon/yautja{
	pixel_x = -6;
	anchored = 1;
	name = "alien harpoon"
	},
/turf/open/floor/sandstone/runed,
/area/lv624/lazarus/sandtemple)
"zE" = (
/turf/open/ground/coast/corner2,
/area/lv624/ground/river3)
"Ai" = (
/obj/structure/glowshroom,
/turf/open/floor/plating/ground/dirt,
/area/lv624/lazarus/sandtemple)
"BW" = (
/turf/open/ground/coast/corner,
/area/lv624/ground/river3)
"Dl" = (
/obj/effect/ai_node,
/turf/open/floor/plating/ground/dirt,
/area/lv624/ground/sand3)
"Dm" = (
/obj/structure/jungle/vines{
	pixel_y = 1
	},
/turf/closed/mineral/smooth,
/area/lv624/ground/caves/rock)
"FN" = (
/obj/effect/landmark/weed_node,
/obj/structure/jungle/vines,
/turf/closed/wall/mineral/sandstone/runed,
/area/lv624/lazarus/sandtemple)
"Gx" = (
/obj/effect/landmark/weed_node,
/turf/open/floor/plating/ground/dirt,
/area/lv624/ground/sand9)
"HH" = (
/obj/item/weapon/claymore/mercsword/machete,
/obj/structure/jungle/vines{
	pixel_y = 1
	},
/turf/open/floor/plating/ground/dirt,
/area/lv624/lazarus/sandtemple)
"HY" = (
/obj/structure/jungle/vines,
/turf/closed/wall/mineral/sandstone/runed,
/area/lv624/lazarus/sandtemple)
"IP" = (
/turf/open/floor/plating/ground/dirtgrassborder/corner2{
	dir = 1
	},
/area/lv624/ground/river3)
"Jt" = (
/turf/open/floor/plating/ground/dirtgrassborder/corner2{
	dir = 1
	},
/area/lv624/ground/jungle8)
"JB" = (
/turf/closed/wall,
/area/lv624/ground/sand9)
"JK" = (
/turf/open/ground/coast/corner{
	dir = 4
	},
/area/lv624/ground/sand6)
"Kb" = (
/obj/effect/landmark/weed_node,
/turf/open/floor/plating/ground/dirt,
/area/lv624/lazarus/sandtemple)
"KB" = (
/turf/open/ground/coast{
	dir = 9
	},
/area/lv624/ground/river3)
"KK" = (
/obj/structure/jungle/vines{
	pixel_y = 1
	},
/turf/open/floor/plating/ground/dirt,
/area/lv624/lazarus/sandtemple)
"Lh" = (
/turf/open/floor/plating/ground/dirt,
/area/lv624/ground/sand3)
"Lr" = (
/turf/open/ground/coast{
	dir = 5
	},
/area/lv624/ground/river3)
"Mo" = (
/obj/structure/platform_decoration{
	icon_state = "stone_deco";
	color = "#b29082";
	resistance_flags = 1;
	name = "sandstone platform";
	dir = 8
	},
/turf/open/ground/coast,
/area/lv624/ground/sand6)
"My" = (
/obj/effect/decal/cleanable/blood/gibs,
/turf/open/floor/plating/ground/dirt,
/area/lv624/lazarus/sandtemple)
"MG" = (
/turf/closed/wall/mineral/sandstone/runed,
/area/lv624/ground/river3)
"OZ" = (
/obj/structure/stairs/seamless{
	dir = 8;
	color = "#ffc9b3";
	resistance_flags = 1
	},
/turf/open/floor/sandstone/runed,
/area/lv624/lazarus/sandtemple)
"PI" = (
/turf/open/ground/coast{
	dir = 4
	},
/area/lv624/ground/river3)
"PL" = (
/obj/structure/jungle/plantbot1/alien,
/turf/open/ground/river,
/area/lv624/ground/river3)
"PY" = (
/obj/structure/jungle/plantbot1/alien,
/obj/structure/jungle/vines{
	pixel_y = 1
	},
/turf/open/floor/plating/ground/dirt,
/area/lv624/lazarus/sandtemple)
"PZ" = (
/obj/structure/jungle/vines,
/obj/effect/spawner/random/tool,
/turf/open/floor/plating/ground/dirt,
/area/lv624/lazarus/sandtemple)
"Qj" = (
/obj/structure/jungle/vines,
/turf/open/floor/plating/ground/dirtgrassborder{
	dir = 1
	},
/area/lv624/ground/jungle8)
"QF" = (
/turf/open/ground/grass,
/area/lv624/ground/jungle8)
"QS" = (
/turf/closed/wall/mineral/sandstone/runed,
/area/lv624/ground/sand6)
"RI" = (
/turf/open/ground/coast/corner2{
	dir = 2
	},
/area/lv624/ground/river3)
"RJ" = (
/obj/effect/ai_node,
/turf/open/ground/coast{
	dir = 4
	},
/area/lv624/ground/river3)
"Sb" = (
/turf/open/ground/river,
/area/lv624/ground/river3)
"Sm" = (
/obj/structure/flora/ausbushes/palebush,
/turf/open/ground/coast/corner2{
	dir = 1
	},
/area/lv624/ground/river3)
"SD" = (
/turf/open/ground/coast/corner{
	dir = 4
	},
/area/lv624/ground/sand3)
"SJ" = (
/obj/structure/stairs/seamless{
	dir = 4;
	color = "#ffc9b3";
	resistance_flags = 1
	},
/turf/open/floor/sandstone/runed,
/area/lv624/lazarus/sandtemple)
"Tp" = (
/turf/open/ground/coast{
	dir = 8
	},
/area/lv624/ground/river3)
"Tt" = (
/obj/structure/jungle/vines{
	pixel_y = 1
	},
/turf/closed/wall/mineral/sandstone/runed,
/area/lv624/lazarus/sandtemple)
"TX" = (
/obj/effect/ai_node,
/turf/open/floor/plating/ground/dirt,
/area/lv624/ground/sand9)
"UN" = (
/obj/structure/flora/ausbushes/reedbush,
/turf/open/ground/coast{
	dir = 1
	},
/area/lv624/ground/river3)
"Wt" = (
/turf/open/floor/plating/ground/dirt,
/area/lv624/ground/sand9)
"Wv" = (
/obj/effect/decal/cleanable/blood/splatter/animated,
/turf/open/floor/plating/ground/dirt,
/area/lv624/lazarus/sandtemple)
"WB" = (
/obj/effect/turf_decal/sandytile,
/turf/open/floor/sandstone/runed,
/area/lv624/lazarus/sandtemple)
"Xv" = (
/obj/structure/jungle/vines,
/obj/machinery/door/airlock/sandstone/runed,
/turf/open/floor/sandstone/runed,
/area/lv624/lazarus/sandtemple)
"Xx" = (
/turf/closed/mineral/smooth,
/area/lv624/ground/caves/rock)
"XR" = (
/obj/effect/turf_decal/warning_stripes/thin{
	dir = 8
	},
/obj/effect/turf_decal/warning_stripes/thin{
	dir = 9
	},
/turf/open/floor/plating/ground/dirt,
/area/lv624/ground/sand9)

(1,1,1) = {"
yr
pO
gq
SD
Lh
Lh
Xx
Xx
Xx
Xx
Xx
Xx
Xx
Wt
Wt
Wt
TX
Wt
hE
qK
Wt
Wt
mq
Sb
"}
(2,1,1) = {"
Mo
gq
JK
Lh
jq
Lh
Lh
Xx
Xx
Xx
Xx
Xx
Xx
Xx
Wt
Wt
Wt
Wt
XR
mT
Wt
Wt
mq
Sb
"}
(3,1,1) = {"
wT
rc
yc
Lh
Lh
Dl
Lh
Xx
Xx
Xx
Xx
Xx
Xx
Xx
Wt
Wt
Gx
Wt
Wt
Wt
Wt
Wt
mq
Sb
"}
(4,1,1) = {"
lg
yc
QS
Lh
oY
Lh
jq
Xx
Xx
Xx
Xx
Xx
Wt
gQ
Wt
Wt
Wt
Wt
Wt
Wt
Wt
Wt
gh
eq
"}
(5,1,1) = {"
lg
yc
QS
Lh
Lh
Lh
Lh
Xx
Xx
Xx
Xx
Wt
Wt
gQ
Wt
vZ
Wt
Wt
Wt
Wt
Wt
vZ
qS
mq
"}
(6,1,1) = {"
tf
OZ
hG
hG
hG
hG
HY
oJ
Dm
Dm
Wt
Wt
Wt
gQ
Wt
Wt
Wt
Wt
Wt
Wt
Wt
Wt
qS
mq
"}
(7,1,1) = {"
yt
yt
om
WB
iX
WB
yL
oJ
Tt
Xx
Wt
Wt
cm
JB
gQ
gQ
fB
JB
gQ
gQ
fB
JB
qS
mq
"}
(8,1,1) = {"
yt
om
om
om
yt
yt
yL
WB
mj
tP
Wt
Wt
Wt
Gx
Wt
Wt
Wt
Wt
Wt
Wt
Wt
Wt
qS
mq
"}
(9,1,1) = {"
yt
sC
WB
yt
dv
yt
yt
dv
Xv
om
Wt
Wt
og
Wt
Wt
Wt
Wt
og
Wt
Wt
BW
PI
PI
zE
"}
(10,1,1) = {"
om
WB
yt
yt
yt
yt
WB
WB
mj
zi
Wt
TX
Wt
Wt
Wt
Wt
Wt
BW
RJ
PI
zE
Sb
Sb
Sb
"}
(11,1,1) = {"
iX
yt
yt
WB
yt
yt
yL
HY
oJ
yt
Wt
Wt
Wt
Wt
Wt
Wt
Wt
mq
Sb
Sb
Sb
Sb
lP
Sb
"}
(12,1,1) = {"
oG
SJ
er
er
er
er
HY
HY
KK
yt
Wt
Wt
Wt
Wt
Wt
BW
PI
zE
eP
qF
Sb
Sb
Sb
Sb
"}
(13,1,1) = {"
nh
yt
oJ
yt
yt
yt
mL
Tt
sy
Tt
Wt
Wt
Wt
og
Wt
mq
Sb
Sb
Sb
Sb
Sb
PL
Sb
Sb
"}
(14,1,1) = {"
nh
yt
HY
yt
yt
yt
yt
PY
KK
sy
Wt
Wt
BW
PI
PI
zE
Sb
Sb
Sb
lP
Sb
Sb
Sb
Sb
"}
(15,1,1) = {"
nh
dv
mz
yt
yt
dv
yt
yt
Wv
yt
Wt
rh
dc
Sb
Sb
Sb
Sb
Sb
PL
Sb
Sb
Sb
Sb
Sb
"}
(16,1,1) = {"
kv
yt
yt
yt
FN
KK
KK
yt
My
yt
BW
dc
Sb
Sb
KB
Sm
Sb
Sb
Sb
Sb
Sb
Sb
Sb
KB
"}
(17,1,1) = {"
Xx
yt
yt
yt
oJ
Tt
sy
yt
HH
oJ
mq
eP
KB
Tp
gX
gh
eq
Sb
Sb
Sb
Sb
lP
KB
gX
"}
(18,1,1) = {"
oJ
Kb
yt
Ai
yt
KK
PZ
yt
KK
oJ
mq
Sb
lu
qS
kp
qS
gh
eq
Sb
lP
Sb
Sb
lu
mm
"}
(19,1,1) = {"
oJ
dv
tl
yt
sy
HY
mL
HY
yt
yt
mq
Sb
UN
qS
qS
qS
vt
mq
Sb
Sb
Sb
KB
gX
Qj
"}
(20,1,1) = {"
hB
tA
My
yt
HY
Xx
mL
mL
mL
BW
RI
Sb
Lr
PI
fY
kp
BW
zE
eP
Sb
KB
gX
Jt
bs
"}
(21,1,1) = {"
oJ
yt
yt
yt
Xx
Xx
Xx
Xx
mL
mq
PL
Sb
Sb
lP
Lr
PI
zE
Sb
Sb
KB
gX
Jt
km
lb
"}
(22,1,1) = {"
oJ
oJ
QS
QS
Xx
Xx
Xx
Xx
mL
mq
Sb
MG
Sb
Sb
Sb
Sb
Sb
Sb
Sb
lu
IP
km
QF
jh
"}
